-----------------------------------------------------------------------------------------------------------------------------------------------------
-----------------------------------------------------------------------------------------------------------------------------------------------------
-----------------------------------------------------------------------------------------------------------------------------------------------------
---------------------------------------------------oo------------------------------------------------------------------------------------------------
--------------------------------------------?-----%%%%-------------------o---------------------------------------------------------------------------
-----------------------SSS-------------------------||-------------------%%%-------------------------oo-----------------------------------------------
---------------------------------------------------||--------------------|--o------o--o---SSS------%%%%----------------------------SSSS--------------
---------------------g----------o----ooo------r----||--SSS---o---o---o---|--SSSS--------------------||--o----R---------------------------------------
-----------------%%%%%%-------------------%%%%%%---||-------%%%-%%%-%%%--|--------------------------||-%%%-------------------SSS---------------------
------------------||||----SSS--------------||||----||--------|---|---|---|---------SSSS-------------||--|------------------------------SSSS----------
------------------||||----------------%%%%-||||ooo-||--------|---|---|---|------------------%%%-----||--|-------------r-r----------------------------
-------------%%%%%||||-----------------||--||||--r-||--------|---|---|---|-------------------|------||-o|---------%%%%%%%%%%%%-----------------------
--------------|||-||||-----------------||%%%%%%%%%%||--------|---|---|---|-----%%%%----------|------||%%%%%--------||||||||||----------------------F-
-M------------|||-||||----oo---%%%%%%%-||-||||||||-||--------|---|-r-|---|------||-----------|------||-|||---------||||||||||----------------------#-
XXXXXXXXXXX---|||-||||---%%%----|||||--||-||||||||-||-------%%%%%%%%%%%%%%%%----||-----------|------||-|||-----%%%-||||||||||--------------XXXXXXXXXX
XXXXXXXXXXX---|||-||||----|-----|||||--||-||||||||-||--------||||||||||||||-----||-----------|------||-|||------|--||||||||||--------------XXXXXXXXXX
