------------------------------------------------------------------------------------------------------------------------------------------------------
------------------------------------------------------------------------------------------------------------------------------------------------------
------------------------------------------------------------------------------------------------------------------------------------------------------
--------------------------------oo--------------------------------------------------------------------------------------------------------------------
-------------------------------------g-g--------------------------------------------------------------------------------------------------------------
----------------------ooor---------%%%%%%%-------------oooo----------R------------------oo--oo--------------------------------------------------------
---------------------%%%%%----------|||||--------------%%%%----------------g----oo---------------------------R-----oo--------------------##-----------
----------------------|||---------SS|||||----oo---------||-------------%%%%%%------------------------r-----------------------------------##-----------
----------------------|||-----------|||||---------------||--------------||||-----------------------%%%%%%%%-------------------SSS------####-----------
----------------------|||-----%%%%%-|||||-SS------SSS---||--------------||||-----SS-----------------||||||-----------------------------####-----------
-------------------%%%%%%%%----|||--|||||---------------||-------%%%----||||-------------SS---------||||||-----%%%%--%%%%------------######-----------
-----------------SS-||||||-----|||--|||||-----SS------U-||--SS----|-----||||------------------------||||||------||----||-------------######-----------
--------------------||||||--o--|||--|||||---------------||------SS|-----||||-----------------%%%%-SS||||||------||----||-------------######--------F--
-M-----------%%%%---||||||-%%%-|||SS|||||SSS------SSS---||--------|SSS--||||-------SSS--SSS---||----||||||S-ooo-||-SS-||-SS------r---######--------#--
XXXXXXXXXXX---||--XX||||||--|--|||--|||||----%%%%-----%%%%%-%%%%%-|-----||||X--XXX------------||-XX-||||||--%%%-||----||----XXXXXXXXXXXXXXXXXXXXXXXXXX
XXXXXXXXXXX---||--XX||||||--|--|||--|||||-----||-------|||---|||--|-----||||X--XXX------------||-XX-||||||---|--||----||----XXXXXXXXXXXXXXXXXXXXXXXXXX
