-----------------------------------------------------------------------------------------------------------------------------------------------------
-----------------------------------------------------------------------------------------------------------------------------------------------------
-----------------------------------------------------------------------------------------------------------------------------------------------------
---------------------------------------------------oo------------------------------------------------------------------------------------------------
--------------------------------------------?-----%%%%-------------------o---------------------------------------------------------------------------
-----------------------SSS-------------------------||-------------------%%%-------------------------oo-----------------------------------------------
---------------------------------------------------||--------------------|--o------o--o---SSS------%%%%----------------------------SSSS--------------
---------------------g----------o----ooo------r----||--SSS---o---o---o---|--SSSS--------------------||--o----R---------------------------------------
-----------------%%%%%%-------------------%%%%%%---||-------%%%-%%%-%%%--|--------------------------||-%%%-------------------SSS---------------------
------------------||||----SSS--------------||||----||--------|---|---|---|---------SSSS-------------||--|------------------------------SSSS----------
------------------||||----------------%%%%-||||ooo-||---S----|---|---|-S-|------------------%%%-----||--|-------------r-r----------------------------
-------------%%%%%||||------XX-------S-||--||||--r-||--------|---|-S-|---|-------------------|------||-o|---------%%%%%%%%%%%%-----------------------
--------------|||-||||-----------------||%%%%%%%%%%||--------|---|---|---|-----%%%%----------|------||%%%%%--------||||||||||----------------------F-
-M----------S-|||-||||SSS-oo---%%%%%%%-||-||||||||-||--SSS---|---|-r-|---|------||--SSS-SSS--|-SSS--||-|||---SSS---||||||||||---SSS-SSS------------#-
XXXXXXXXXXX---|||-||||---%%%-XX-|||||--||X||||||||X||-------%%%%%%%%%%%%%%%%----||-----------|------||-|||-----%%%-||||||||||--------------XXXXXXXXXX
XXXXXXXXXXX---|||-||||----|--XX-|||||--||X||||||||X||--------||||||||||||||-----||-----------|------||-|||------|--||||||||||--------------XXXXXXXXXX
