------------------------------------------------------------------------------------------------------------------------------------------------------
------------------------------------------------------------------------------------------------------------------------------------------------------
------------------------------------------------------------------------------------------------------------------------------------------------------
--------------------------------oo--------------------------------------------------------------------------------------------------------------------
---------------------------------------g-g------------------------------------------------------------------------------------------------------------
----------------------ooor---------%%%%%%%-------------oooo----------R------------------oo--oo--------------------------------------------------------
---------------------%%%%%----------|||||--------------%%%%----------------g----oo---------------------------R-----oo--------------------##-----------
----------------------|||-----------|||||----oo---SSSS--||-------------%%%%%%----------------------------r-------------------------------##-----------
----------------------|||-----------|||||---------------||--------------||||-----------------------%%%%%%%%----------------------------####-----------
----------------------|||-----%%%%%-|||||---------------||--------------||||-----SSS----------------||||||---------------------SSS-----####-----------
-------------------%%%%%%%%----|||--|||||-------SS------||-------%%%----||||-------------SSS-----SSS||||||-----%%%%--%%%%------------######-----------
--------------------||||||-----|||--|||||-------------U-||--------|-----||||------------------------||||||-SS---||----||-------------######-----------
-----------------SSS||||||--o--|||--|||||-SSS-----------||----SS--|-----||||-----------------%%%%---||||||------||----||SSS-------SS-######--------F--
-------------%%%%---||||||-%%%-|||--|||||-----------SS--||--------|-----||||-------SSS--------||----||||||--ooo-||----||---------r---######--------#--
XXXXXXXXXXX---||----||||||--|--|||--|||||----%%%%-----%%%%%-%%%%%-|-XXX-||||--XXX--------XX---||-XX-||||||--%%%-||----||----XXXXXXXXXXXXXXXXXXXXXXXXXX
XXXXXXXXXXX---||----||||||--|--|||--|||||-----||-------|||---|||--|-XXX-||||------------------||----||||||---|--||----||----XXXXXXXXXXXXXXXXXXXXXXXXXX
