------------------------------------------------------------------------------------------------------------------------------------------------------------------------------------------------------
------------------------------------------------------------------------------------------------------------------------------------------------------------------------------------------------------
------------------------------------------------------------------------------------------------------------------------------------------------------------------------------------------------------
------------------------------------------------------------------------------------------------------------------------------------------------------------------------------------------------------
------------------------------------------------------------------------------------------------------------------------------------------------------------------------------------------------------
------------------------------------------------------------------------------------------------------------------------------------------------------------------------------------------------------
-------------------------------------------------------------------------------------SUS------------------------------------------------------------------------------------------------##------------
----------------------------------------------------------------------------------------------------------------------------------------------------------------------------------------##------------
-------------------------------------------------------------------------------------------------------------------------------------------------------TT-------------------------------##------------
-------------------------------------------------------------------------------------------------------------------------------------------------------TT------------------------K---#--##------------
------------------------------------------------------------------------------------#####-----------------------------------------------------#LSS-----##---------------------------##--##------------
---------------------------------------TT-----TT----K-------------------------------#--------------------------#------------------------------#------------------------------------###--##------------
---------------------------------------TT-----TT-----------------------------------K#---------------------*----#------------------------------#-----------*---TT-----*------------####------------F---
-M--------k---ggg--------ggg---------kkTT-----TT-----------ggg-------ggg------------#--------------ggg----*----#----ggg--k----ggg-----------kk#-----------*---TT-----*-----K-----#####------------#---
XXXXXXXXXXXXXXXXXXXXXXXXXXXXXXXXXXXXXXXXXXX--XXXXXXXXXXXXXXXXXXXXXXXXXXXXXXXXXXXXXXXXXX----XXXXXXXXXXXXXXXXXX--XXXXXXXXXXXXXXXXXXXXXXXXXXXXXXXXXXXX---XXXXXXXXXXXXXXXXXXXXXXXXXXXXXXXXXXXXXXXXXXXXXXXX
XXXXXXXXXXXXXXXXXXXXXXXXXXXXXXXXXXXXXXXXXXX--XXXXXXXXXXXXXXXXXXXXXXXXXXXXXXXXXXXXXXXXXX----XXXXXXXXXXXXXXXXXX--XXXXXXXXXXXXXXXXXXXXXXXXXXXXXXXXXXXX---XXXXXXXXXXXXXXXXXXXXXXXXXXXXXXXXXXXXXXXXXXXXXXXX
