--------------------------------------------------------------------------------------------------------------------------------------------------------------
--------------------------------------------------------------------------------------------------------------------------------------------------------------
--------------------------------------------------------------------------------------------------------------------------------------------------------------
S-----SSSSSSSSSSSSSSSSSSSSSSSSSSSSSSSSSSSSSSSSSSSSSSSSSSSSSSSSSSSSSSSSSSSSSSSSSSSSSSSSSSSLSSSSSSSSSSSSSSSSSSSSSSSSSSSSSSSSSSSSSSSSSSSSSSSS--------------------
S-----------------------------------------------------SS--SSSSSS--SSSS------SSSS------------------------------------------------------------------------------
S-----------------------------------------------------SS--SSSSSS--SSSS---g--SSSS------------------------------------------------------------------------------
S----------------------------------------oooo-------SS--------SS---S----SS----------oooooo--------------------------------------------------SSS---------------
S---------------------------------------------------SS--------SS---S----SS------------------------------------------------------------------------------------
S--------------------------------------S-SSSS-U-----SS--------SS---S----SS----------SSSSSS--------------------------------------------------------------------
S----------------------------C---------SoS--SoS-----SS----ooooSS---SoU--SC--g-g-----SSSSSS-------------------------------------------------------SSSSSSU------
S---------@QQQQ--------#-#-------------SSS--SSS-----SSSS--SSSSSS---SSS--SS--SSSS-----------------------------TT------------------------g##--------------------
S--------------------#-#-#-#---#----------------------SS-----------------------------------------------TT----TT-----------SS-----------###--------------------
S----------------g-#-#-#-#-#---#-#---------------------------------------------------------------------TT---STT----TT-----SS---------g####--SSS---------------
S--M------------g#-#-#-#-#-#-E-#-#--------kk----------------k--g-g------------------------------g-g-g--TT---STT--g-TT-----SS---------#####---------r--------F-
XXXXXXXXXXXXXXXXXXXXXXXXXXXXXXXXXXXXXXXXXXXXXXXXXXXXXXXXXXXXXXXXXXXXXXXXXXXXXXXX---XXXXXXXXXXXXXXXXXXXXXXXXXXXXXXXXXXXXX--XX--XXXXXXXXXXXX---X---XXXXXXXX--XXX
XXXXXXXXXXXXXXXXXXXXXXXXXXXXXXXXXXXXXXXXXXXXXXXXXXXXXXXXXXXXXXXXXXXXXXXXXXXXXXXX---XXXXXXXXXXXXXXXXXXXXXXXXXXXXXXXXXXXXX--XX--XXXXXXXXXXXX-------XXXXXXXX--XXX
